NO ./path_to_the_north_texture
SO ./path_to_the_south_texture
WE ./path_to_the_west_texture
EA ./path_to_the_east_texture

F       220      100,      0
C 225, 200, 01

        1111111111111111111111111
        1000000000110000000000001
        1011000001110000000000001
        1001000000000000000000001
111111111111000001110000000000001
1000000000011000001110111111111111
111111111111110111000000010001
11110111111111011101010010001
11000000110101011100000010001
100000000000000001100N00010001
10000000000000001101010011111
1100000101010101111101111101111
1111011101110101 111111010101
111111111111111 111111111111