NO ./textures/north.xpm
SO ./textures/south.xpm
WE ./textures/west.xpm
EA ./textures/east.xpm
F   100, 100, 100
C       0, 0, 0


        111111111111111111111111
        10000E0000110000000000001
        1011000001110000010000001
        1001000000000000001000001
 11111111011000001110000000000001
10000000001100101110111111111111
1110111111111011111000010001
11110111111111011101010010001
11111111111111111111111111111
